1111111111111
10010000E0C01
1000011111001
1P00110000001
1111111111111