11111111111111111111
1E000000000C00000C01
10101100100001010101
10101010101010010101
1P0000C00C0000000001
10000000000C0000C001
1000000C000000000001
11111111111111111111